R  800  400
NO  ./path_to_the_north_texture.xpm
SO  ./path_to_the_south_texture.xpm


WE  ./path_to_the_west_texture.xpm
EA  ./path_to_the_east_texture.xpm

S  ./path_to_the_sprite_texture.xpm
F  226,   149,  120
C 150, 193, 106

        11111111111 1111111111111
        10000000001 1000000000111
        10110000011110000000001
        1001000000000000000000111
111111111011000001110000000000001
100000000011110001110111111111111
11110111111  1011100000010001
  110111111  1011101000000001
11100000111111011100000001001
1000200000000000110000E010001
10000000000000001111010010001
11000001110101011 1101111000111
11110111 1110101   101111010001
11111111 1111111   111111111111
