R  1920 1080
NO  ressources/textures/redbrick.xpm
SO  ressources/textures/bookshelf.xpm


WE  ressources/textures/colorstone.xpm
EA  ressources/textures/mossy.xpm
S   ressources/textures/redbrick.xpm

F  226,   149,  120
C 150, 193, 106

        11111111111 1111111111111
        10000000001 1000000000111
        11110000011110000000001
        1001000000000000000000111
111111111011000001110000000000001
100000000011110001110111111111111
11110111111  1011100000010001
  110111111  1011101000000001
11100200111111011100000001001
100000000002000W1100000010001
10020000002000001111010010001
11000201110101011 1101111000111
11110111 1110101   101111010001
11111111 1111111   111111111111
