R  1920 500000
NO  ressources/textures/redbrick.xpm
SO  ressources/textures/bookshelf.xpm


WE    ressources/textures/colorstone.xpm
EA  ressources/textures/mossy.xpm
S       ressources/textures/barrel.xpm

F  226,   149,  120
C      150, 193, 106

        11111111111 1111111111111
        10000000001 1000000000111
        11110000011110000000001
        1001000000000000200000111111111111
111111111011000001110200000E00000000000001
100000000011110001110111111111111111111011
11110111111  1011100000010001         1001
  110111111  1011101000000001         1001
11100200111111011100000001001    111111001
10000000000200001100000010001    100000001
10020000200000001111010010001    111111111
11000201110101011 1101111000111
11110111 1110101   101111010001
11111111 1111111   111111011111
                        101
               1111111111011111111
               1000000000000000001
               1111111111111111111
